#####################################
#                                   #                          
#                                   #                           |                                         
#                                   #                        
#                                   #                       
#################|###################
#
#
#
#
############################
#
#
#
#
#
#################################