#########################
#@|     |               #
####################    #
#        #         #    #
#                       # 
#|#######################
                                                                                                                                                                                   
                                                                                                                                                                                 #########################
                                                                                                                                                                                 #@|     |               #
                                                                                                                                                                                 ###################    #
                                                                                                                                                                                 #        #         #    #
                                                                                                                                                                                                        # 
                                                                                                                                                                                 #|#######################         
                                                                                                                                                                                    
                                                                                                                                                                                    