#############################
#        b   ##### #        #
#        #  t#     |        #
#        #  #@#    |t       #
#        #+ #####-#####     #
#          #@#       |      #
#           #          ##   #
#############################