#############################
#        b   ##### #        #
#        #  t#     |        #
#        #c #@#    #t       #
#        #+ #####-#####     #
#          #@#   !   |      #
#           #          ##   #
#############################