#############################
# @      b   #####          #
#        #  t       b       #
#        #  #      |t       #
#        #+ #     #####     #
#          #         |      #
#           @          ##   #
#############################