#############################
#        b   ##### #        #
#        #  t#     |        #
#        #c # #    #t       #
#   @     #+ #####-#####    #
#    @      # #   !   |     #
#           #          ##   #
#############################