#############################
# @           #####         #
#           t      |        #
#            #      |t      #
#           #     #####     #
#          #         |      #
#           @          ##   #
#############################