#############################
# @      b   ##### #        #
#        #  t      |        #
#        #  #      |t       #
#        #+ #|###-#####     #
#          #         |      #
#           @          ##   #
#############################